00000000000000000000
01111111131111111130
01133333333333331110
01111111131131111130
01133331131131133330
01131111131111111110
03333331133331133330
01111111111111111130
03331133333331133330
01111111131111111110
01133333333331133330
01111131131131111110
01131131131133333330
01131111131131131110
03333331131131131130
01111111111111111110
01133333331131133330
01111111131131111130
01133331133331131120
00000000000000000000